 *-----------*
 |A V B C D X|
 |-------- --|
>|E Z F G H Y|
 |---- ------|
 |K L M N O A|>
 | ----------|
 |Q R S T U H|
 *-----------*