 *---------* 
>|A B C D X| 
 |-- ------| 
 |E F G H Y| 
 |---- ----| 
 |K L M N O| 
 |-------- | 
 |Q R S T U|>
 *---------* 
 

 *---------* 
>|A-B C D X| 
 |-- ------| 
 |E F G H Y| 
 |---- ----| 
 |K L M N O| 
 |-------- | 
 |Q R S T U|>
 *---------* 
 

 *---------* 
>|A-B-C D X| 
 |-- ------| 
 |E F G H Y| 
 |---- ----| 
 |K L M N O| 
 |-------- | 
 |Q R S T U|>
 *---------* 
 

 *---------* 
>|A-B-C D X| 
 |--|------| 
 |E F G H Y| 
 |---- ----| 
 |K L M N O| 
 |-------- | 
 |Q R S T U|>
 *---------* 
 

 *---------* 
>|A-B-C-D X| 
 |--|------| 
 |E F G H Y| 
 |---- ----| 
 |K L M N O| 
 |-------- | 
 |Q R S T U|>
 *---------* 
 

 *---------* 
>|A-B-C-D X| 
 |--|------| 
 |E-F G H Y| 
 |---- ----| 
 |K L M N O| 
 |-------- | 
 |Q R S T U|>
 *---------* 
 

 *---------* 
>|A-B-C-D X| 
 |--|------| 
 |E-F-G H Y| 
 |---- ----| 
 |K L M N O| 
 |-------- | 
 |Q R S T U|>
 *---------* 
 

 *---------* 
>|A-B-C-D-X| 
 |--|------| 
 |E-F-G H Y| 
 |---- ----| 
 |K L M N O| 
 |-------- | 
 |Q R S T U|>
 *---------* 
 

 *---------* 
>|A-B-C-D-X| 
 |--|------| 
 |E-F-G-H Y| 
 |---- ----| 
 |K L M N O| 
 |-------- | 
 |Q R S T U|>
 *---------* 
 

 *---------* 
>|A-B-C-D-X| 
 |--|------| 
 |E-F-G-H Y| 
 |----|----| 
 |K L M N O| 
 |-------- | 
 |Q R S T U|>
 *---------* 
 

 *---------* 
>|A-B-C-D-X| 
 |--|------| 
 |E-F-G-H-Y| 
 |----|----| 
 |K L M N O| 
 |-------- | 
 |Q R S T U|>
 *---------* 
 

 *---------* 
>|A-B-C-D-X| 
 |--|------| 
 |E-F-G-H-Y| 
 |----|----| 
 |K L-M N O| 
 |-------- | 
 |Q R S T U|>
 *---------* 
 

 *---------* 
>|A-B-C-D-X| 
 |--|------| 
 |E-F-G-H-Y| 
 |----|----| 
 |K L-M-N O| 
 |-------- | 
 |Q R S T U|>
 *---------* 
 

 *---------* 
>|A-B-C-D-X| 
 |--|------| 
 |E-F-G-H-Y| 
 |----|----| 
 |K-L-M-N O| 
 |-------- | 
 |Q R S T U|>
 *---------* 
 

 *---------* 
>|A-B-C-D-X| 
 |--|------| 
 |E-F-G-H-Y| 
 |----|----| 
 |K-L-M-N-O| 
 |-------- | 
 |Q R S T U|>
 *---------* 
 

 *---------* 
>|A-B-C-D-X| 
 |--|------| 
 |E-F-G-H-Y| 
 |----|----| 
 |K-L-M-N-O| 
 |--------|| 
 |Q R S T U|>
 *---------* 
 

 *---------* 
>|A-B-C-D-X| 
 |--|------| 
 |E-F-G-H-Y| 
 |----|----| 
 |K-L-M-N-O| 
 |--------|| 
 |Q R S T-U|>
 *---------* 
 

 *---------* 
>|A-B-C-D-X| 
 |--|------| 
 |E-F-G-H-Y| 
 |----|----| 
 |K-L-M-N-O| 
 |--------|| 
 |Q R S-T-U|>
 *---------* 
 

 *---------* 
>|A-B-C-D-X| 
 |--|------| 
 |E-F-G-H-Y| 
 |----|----| 
 |K-L-M-N-O| 
 |--------|| 
 |Q R-S-T-U|>
 *---------* 
 

 *---------* 
>|A-B-C-D-X| 
 |--|------| 
 |E-F-G-H-Y| 
 |----|----| 
 |K-L-M-N-O| 
 |--------|| 
 |Q-R-S-T-U|>
 *---------* 
 

