 *-----------* 
 |A V B C D X|>
 |------ ----| 
 |E Z S G H Y| 
 |-- --------| 
>|K L M N O U| 
 *-----------* 

 

 *-----------* 
 |A V B C D X|>
 |------ ----| 
 |E Z S G H Y| 
 |-- --------| 
>|K-L M N O U| 
 *-----------* 

 

 *-----------* 
 |A V B C D X|>
 |------ ----| 
 |E Z S G H Y| 
 |-- --------| 
>|K-L-M N O U| 
 *-----------* 

 

 *-----------* 
 |A V B C D X|>
 |------ ----| 
 |E Z S G H Y| 
 |-- --------| 
>|K-L-M-N O U| 
 *-----------* 

 

 *-----------* 
 |A V B C D X|>
 |------ ----| 
 |E Z S G H Y| 
 |-- --------| 
>|K-L-M-N-O U| 
 *-----------* 

 

 *-----------* 
 |A V B C D X|>
 |------ ----| 
 |E Z S G H Y| 
 |-- --------| 
>|K-L-M-N-O-U| 
 *-----------* 

 

 *-----------* 
 |A V B C D X|>
 |------ ----| 
 |E Z S G H Y| 
 |--|--------| 
>|K-L-M-N-O-U| 
 *-----------* 

 

 *-----------* 
 |A V B C D X|>
 |------ ----| 
 |E-Z S G H Y| 
 |--|--------| 
>|K-L-M-N-O-U| 
 *-----------* 

 

 *-----------* 
 |A V B C D X|>
 |------ ----| 
 |E-Z-S G H Y| 
 |--|--------| 
>|K-L-M-N-O-U| 
 *-----------* 

 

 *-----------* 
 |A V B C D X|>
 |------ ----| 
 |E-Z-S-G H Y| 
 |--|--------| 
>|K-L-M-N-O-U| 
 *-----------* 

 

 *-----------* 
 |A V B C D X|>
 |------|----| 
 |E-Z-S-G H Y| 
 |--|--------| 
>|K-L-M-N-O-U| 
 *-----------* 

 

 *-----------* 
 |A V B-C D X|>
 |------|----| 
 |E-Z-S-G H Y| 
 |--|--------| 
>|K-L-M-N-O-U| 
 *-----------* 

 

 *-----------* 
 |A V-B-C D X|>
 |------|----| 
 |E-Z-S-G H Y| 
 |--|--------| 
>|K-L-M-N-O-U| 
 *-----------* 

 

 *-----------* 
 |A-V-B-C D X|>
 |------|----| 
 |E-Z-S-G H Y| 
 |--|--------| 
>|K-L-M-N-O-U| 
 *-----------* 

 

 *-----------* 
 |A-V-B-C-D X|>
 |------|----| 
 |E-Z-S-G H Y| 
 |--|--------| 
>|K-L-M-N-O-U| 
 *-----------* 

 

 *-----------* 
 |A-V-B-C-D-X|>
 |------|----| 
 |E-Z-S-G H Y| 
 |--|--------| 
>|K-L-M-N-O-U| 
 *-----------* 

 

 *-----------* 
 |A-V-B-C-D-X|>
 |------|----| 
 |E-Z-S-G-H Y| 
 |--|--------| 
>|K-L-M-N-O-U| 
 *-----------* 

 

 *-----------* 
 |A-V-B-C-D-X|>
 |------|----| 
 |E-Z-S-G-H-Y| 
 |--|--------| 
>|K-L-M-N-O-U| 
 *-----------* 

 

